2,10,12,6,12,2,10,10,10,12
6,8,3,9,3,12,6,14,10,13
5,6,10,12,6,9,5,7,12,5
5,7,14,9,3,10,9,5,1,5
5,5,3,10,12,6,10,13,6,9
5,5,2,12,5,3,14,11,9,4
7,11,10,11,13,6,11,12,6,13
5,4,6,10,9,5,2,15,9,5
5,5,7,10,12,3,12,7,14,13
3,11,11,10,11,10,11,11,11,9
