0,1,2,3,4,5,6,7,8,9
4,2,14,14,10,12,6,12,2,12
3,12,1,3,12,3,9,3,10,13
6,9,6,10,9,6,10,12,2,13
5,2,11,10,12,7,8,3,12,5
5,6,10,12,5,5,6,10,9,5
3,9,4,5,3,9,7,10,12,5
2,10,13,3,10,12,1,6,9,5
6,10,9,6,10,9,6,9,6,9
7,10,12,5,2,14,9,6,9,4
3,8,3,11,10,9,2,11,10,9
