4,6,10,8,6,10,10,14,14,8
5,3,10,10,9,6,12,1,3,12
3,10,10,10,12,5,3,12,6,13
6,12,2,12,3,9,4,3,9,5
5,5,6,11,10,10,11,12,4,5
5,3,13,2,10,14,8,3,13,5
5,6,9,6,12,7,10,10,9,5
5,1,6,9,5,1,6,10,10,9
7,10,9,4,3,10,9,6,12,4
3,10,10,11,10,10,10,9,3,9
